#scene_width	sceen_height	cam_x	cam_y	max_cam_x	max_cam_y
[SETTINGS]
250	250	0	0	2480	0

# id	file_path	transparent_color_r	g	b
[TEXTURES]
30	mapfiles\world1.png	3	26	110
50	textures\hud-font.png	81	255	191

# id	file_path	texture_id
[SPRITES]
30	data\worldmap-sprite.txt	30
50	data\hud-sprite.txt	50

# ani_id	file_path	
[ANIMATIONS]
30	data\worldmap-animation.txt

#
# id	ani1	ani2	ani3
#
[ANIMATION_SETS]
# MARIO
430	53001 
# TREE
431	53101	

[OBJECTS]
# type	x	y	ani_set_id	extra_settings per object type
# type: 
# 101 = Mario 
# 100 = Tree

# MARIO
101	24	47	430

# TREE
100	8	15	431
100	24	15	431
100	40	15	431
100	8	31	431
100	24	31	431
100	40	31	431
100	8	63	431
100	24	63	431
100	40	63	431
100	8	79	431
100	24	79	431
100	40	79	431
100	8	95	431
100	72	31	431
100	88	31	431
100	104	31	431
100	72	47	431
100	88	47	431
100	104	47	431
100	72	63	431
100	88	63	431
100	104	63	431
100	136	31	431
100	152	31	431
100	168	31	431
100	200	15	431
100	216	15	431
100	200	31	431
100	216	31	431
100	200	47	431
100	216	47	431
100	136	63	431
100	152	63	431
100	168	63	431
100	184	63	431
100	200	63	431
100	216	63	431
100	136	79	431
100	152	79	431
100	216	79	431
100	88	95	431
100	104	95	431
100	120	95	431
100	216	95	431
100	216	111	431
100	216	127	431
100	216	143	431

# MAP POINT
#type	x	y	ani_set	id(idx)	top	right	bottom	left(-1-no, others-move to index)	screen_id
102	24	47	0	0	-1	1	-1	-1	-1
102	56	47	0	1	2	-1	-1	0	-1
102	56	15	0	2	-1	3	1	-1	2
102	88	15	0	3	-1	4	-1	2	-1
102	120	15	0	4	-1	5	9	3	-1
102	152	15	0	5	-1	6	-1	4	-1
102	184	15	0	6	-1	-1	7	5	-1
102	183	47	0	7	6	-1	-1	8	-1
102	152	47	0	8	-1	7	-1	9	-1
102	120	47	0	9	4	8	10	-1	-1
102	120	79	0	10	9	-1	-1	11	-1
102	88	79	0	11	-1	10	-1	12	-1
102	56	79	0	12	-1	11	13	-1	-1
102	56	111	0	13	12	-1	14	-1	-1
102	56	143	0	14	13	15	-1	-1	-1
102	88	143	0	15	-1	16	-1	14	-1
102	120	143	0	16	17	-1	-1	15	-1
102	120	111	0	17	-1	19	16	18	-1
102	88	111	0	18	-1	17	-1	-1	-1
102	152	111	0	19	-1	20	-1	18	-1
102	184	111	0	20	-1	-1	-1	19	-1


[MAP]
1	mapfiles\world1.txt


